Three Boxes 4
7,9
.wwwwww
wwAw..w
w.*...w
w...*.w
wwww.ww
w.....w
w....ow
w..w..w
wwwwwww
